EAEWEWEWEE
EEWEWEWEWE
EWEEEEEEEE
EWEWEWWWWE
EDEWEEEEWE
EWEEEEWEWE
EWEWWWWEWE
EEEWEEEEWW
EWEWWWWWWW
WEEEEEEEEE
