EEEWEWEWEE
EEWEWEWEWE
EWEEEEEEEE
EWEWEWWWWE
EWEWEEEEWE
EWEEEEWEWE
EWEWWWWEWE
EEEWEEEEWW
EWEWWWWWWW
WEEEEEEEEE
